XXXXXXXXXXXXXXXXXXXXXX
X   X   XX XX     X G 
X X   X       XXX X XX
X X X  XX  XXXX   X XX
XXX XXXXXX    XXX X  X
X          XX  XX    X
XXXXX XXXXXX   XXXXX X
X     X   XXXXXXX  X X
X XXXXXXX      S X   X
X                X XXX
XXXXXXXXXXXXXXXXXXXXXX